C C C C C C C C C C C C C C C C C C C C C C C C C C C C C C C C C C C C C C C C C C C C C C C C C C
C C C C C C C C C C C C C C C C C C C C C C C C C C C C C C C C C C C C C C C C C C C C C C C C C C
C C C C C C C C C C C C C C C C C C C C C C C C C C C C C C C C C C C C C C C C C C C C C C C C C C
T T T T T C C T T T T T C C C C C C C C C C C C T T T T T T T T T T T T T T T T T T T T T T T T T T
T T T T T C C T T T T T C C C C C C C C C C C C T T T T T T T T T T T T T T T T T T T T T T T T T T
T T T T T C C T T T T T C C C C C C C C C C C C T T T T T T T T T T T T T T T T T T T T T T T T T T
T T T T T C C T T T T T C C C C C C C C C C C C T T T T T T T T T T T T T T T T T T T T T T T T T T
T T T T T T T T T T T T T T T T T T T T T T T T T T T T T T T T T T T T T T T T T T T T T T T T T T
T T T T T T T T T T T T T T T T T T T T T T T T T T T T T T T T T T T T T T T T T T T T T T T T T T
T T T T T T T T T T T T T T T T T T T T T T T T T T T T T T T T T T T T T T T T T T T T T T T T T T
T T T T T T T T T T T T T T T T T T T T T T T T T T T T T T T T T T T T T T T T T T T T T T T T T T
T T T T T T T T T T T T T T T T T T T T T T T T T T T T T T T T T T T T T T T T T T T T T T T T T T
C C C C C C C C C C T T T T T T T T T T T T T C C C C C C C C C C C C T T T T T T T T T T T T C C C
C C C C C C C C C C T T T T T T T T T T T T T C C C C C C C C C C C C T T T T T T T T T T T T C C C
C C C C C C C C C C T T T T T T T T T T T T T C C C C C C C C C C C C T T T T T T T T T T T T C C C
C C C C C C C C C C T T T T T T T T T T T T T C C C C C C C C C C C C T T T T T T T T T T T T C C C
C C C C C C C C C C T T T T T T T T T T T T T C C C C C C C C C C C C T T T T T T T T T T T T C C C
C C C C C C C C C C T T T T T T T T T T T T T C C C C C C C C C C C C T T T T T T T T T T T T C C C
C C C C C C C C C C T T T T T T T T T T T T T C C C C C C C C C C C C T T T T T T T T T T T T C C C
C C C C C C C C C C T T T T T T T T T T T T T T T T C C C C T T T T T T T T T T T T T T T T T C C C
C C C C C C C C C C T T T T T T T T T T T T T T T T C C C C T T T T T T T T T T T T T T T T T C C C
C C C C C C C C C C T T T T T T T T T T T T T T T T C C C C T T T T T T T T T T T T T T T T T C C C
C C C C C C C C C C T T T T T T T T T T T T T T T T C C C C T T T T T T T T T T T T T T T T T C C C
C C C C C C C C C C C C C C C C C C C C C C T T T T C C C C T T T T C C C C C C C C C C C C C C C C
C C C C C C C C C C C C C C C C C C C C C C T T T T C C C C T T T T C C C C C C C C C C C C C C C C
C C C C C C C C C C C C C C C C C C C C C C T T T T T T T T T T T T C C C C C C C C C C C C C C C C
C C C C C C C C C C C C C C C C C C C C C C T T T T T T T T T T T T C C C C C C C C C C C C C C C C
C C C C C C C C C C C C C C C C C C C C C C T T T T T T T T T T T T C C C C C C C C C C C C C C C C
C C C C C C C C C C C C C C C C C C C C C C T T T T T T T T T T T T C C C C C C C C C C C C C C C C
C C C C C C C C C C C C C C C C C C C C C C T T T T T T T T T T T T C C C C C C C C C C C C C C C C
C C C C C C C C C C C C C C C C C T T T T T T T T T T T T T T T T T T T T T T C C C C C C C C C C C
C C C C C C C C C C C C C C C C C T T T T T T T T T T T T T T T T T T T T T T C C C C C C C C C C C
C C C C C C C C C C C C C C C C C T T T T T T T T C C C C C C T T T T T T T T C C C C C C C C C C C
C C C C C C C C C C C C C C C C C T T T T T T T C C C C C C C C T T T T T T T C C C C C C C C C C C
C C C C C C C C C C C C C C C C C T T T C C C C C C C C C C C C C C C C T T T C C C C C C C C C C C
C C C C C C C C C C C C C C C C C T T T C C C C C C C C C C C C C C C C T T T C C C C C C C C C C C
C C C C C C C C C C C C C C C C C T T T C C C C C C C C C C C C C C C C T T T C C C C C C C C C C C
C C C C C C C C C C C C C C C C C T T T T T T T T T T T T T T T T T T T T T T C C C C C C C C C C C
C C C C C C C C C C C C C C C C C T T T T T T T T T T T T T T T T T T T T T T C C C C C C C C C C C
C C C C C C C C C C C C C C C C C C C C C C C C T T T T T T T T C C C C C C C C C C C C C C C C C C
C C C C C C C C C C C C C C C C C C C C C C T T T T T T T T T T T T C C C C C C C C C C C C C C C C
C C C C C C C C C C C C C C C C C C C C C C T T T T T T T T T T T T C C C C C C C C C C C C C C C C
C C C C C C C C C C C C C C C C C C C C C C T T T T T T T T T T T T C C C C C C C C C C C C C C C C
C C C C C C C C C C C C C C C C C C C C C C T T T T T T T T T T T T C C C C C C C C C C C C C C C C
C C C C C C C C C C C C C C C C C C C C C C C C C C C C C C C C C C C C C C C C C C C C C C C C C C
C C C C C C C C C C C C C C C C C C C C C C C C C C C C C C C C C C C C C C C C C C C C C C C C C C
C C C C C C C C C C C C C C C C C C C C C C C C C C C C C C C C C C C C C C C C C C C C C C C C C C
C C C C C C C C C C C C C C C C C C C C C C C C C C C C C C C C C C C C C C C C C C C C C C C C C C
C C C C C C C C C C C C C C C C C C C C C C C C C C C C C C C C C C C C C C C C C C C C C C C C C C
C C C C C C C C C C C C C C C C C C C C C C C C C C C C C C C C C C C C C C C C C C C C C C C C C C
